A ###################################################################################################
              #   #   #   #       #   #   # #   #   #   #     #     # # #       #             # #   #
####### # ### # ##### # # ##### ##### ### # ### # # # ### ### # ##### # # ############# # ### # # # #
# # #   #   # #   #     #   #     #             # #   # # #         #             #   # # # #     # #
# # ### ####### ### ############# # # ### ### # # # # # ### # ### # # # ######### # ####### ### #####
#       #         # #   #           #   # #   #   # #     # # # # #   # #   # # #     #   #   #   # #
### ######### # ### # ####### ### ### # # ##### # ##### ####### # ##### # ### # # ##### # ### ### # #
# # # #       #   #   #       # # # # # # #     # # # #       #   # # # #   #   #       #       #   #
# # # ####### ##### ##### ### # ### ####### ##### # # ####### # ### # # # ### ### # ### ### ### # ###
#       # # #       # #   # #   # #           # #   #   #       # # #       # #   # # # #   #       #
# ####### # ####### # # # # ##### # # ### ### # ### ### ####### # # ### ### # ####### ### # ##### ###
#   #     #             # # #   #   # # # # #   #   #     #     #   # #   #     #       # #   #     #
# # # ### ### ############# ### # # ### ### ##### # ### # # # ### ### ############# ### # # ### ### #
# #     # # #       #     #     # # # # # #   #   # #   #   # # #   #   # #   # # #   # # # #     # #
### # # # # ### ### # ### ### # ### # # # # # ##### ##### # ### # ### ### ### # # # # ##### ### # ###
#   # # #     #   #     # #   #   #   #     #   #       # # # #       #     #       #   #   #   # # #
# ####### ### ### ### # ### ##### ##### ### ##### ######### # # ####### # # # # ##### # ### # ##### #
# # # #   #   #     # # #   #     #   # # #               #   #   #   # # # # # #   # # #   #   #   #
# # # ####### # # ### # ####### ### ### # ############# ##### # ### ####### ### # # ######### # # ###
#   #   #   #   # #   # # #           # #           #   #     # # #     # #     # #   #       #     #
##### ### ### ######### # # ### ### ### ### ### ##### ##### ### # ### ### ### # ### ######### ### ###
#     #           #   # #   #     # #       #   # # # # # #         # #       # # #   #   #     # # #
# # # ### ##### ##### # # # ### ### ##### ##### # # # # # # # ### ### ##### # # # ### # ##### # ### #
# # # # # #       #     # # #     # # #   # #   # #   #   # # #             # # # #       #   #     #
# ##### # ### # ### ##### # ######### # # # ##### ####### ########### ####### ### ### ######### # ###
# #     # #   #   # #   # #         # # #   #   # # # #     # #     # # # #   # # # #     # #   #   #
# ##### # ######### # ####### # ### # # ####### # # # ##### # # # ### # # ### # # # ### # # ####### #
#             #   #   #       # #     #   #       # #       #   #       # #   # # #     #       # # #
# ####### # ### ### # # # # ##### ######### ##### # ##### ####### ####### ### # # ##### ### # ### # #
#   #   # #       # #   # # #   # #   #   #   # #   #     #     #       #     #         # # #   # # #
##### ##### ####### ### ####### ### ### # # ### ##### ##### # ### ##### ####### # # ##### # ##### ###
# # #           #   # # #             # # #   #   # #     # # # # # # # # #   # # #     # #         #
# # # ### ### # ##### # ### # # # ### # # # # # ### # ### ### # # # # ### ### ### # ##### ####### ###
#     #     # #       # # # # # # #     # # #   #       # #   #     #       #     #     #       # # #
### ####### ### ### ### # ####### ############# # ### # # ### ############# ########### # # # ### # #
#   # #     # # # #   # #         # #         # # #   # #     #               # #         # # #     #
# ### ### ### # # ### ### ######### ####### ### # # ########### # # ########### ##### # ### ### ### #
#       # #       #     # #     # #   #   #     # #         # # # # # #     # # #     #   # #     # #
####### ##### ########### ##### # # # # ##### # ##### ##### # # ##### # # # # # ### ####### # ##### #
# #       #   #   #   #         #   #     #   # # #   # #         #   # # #       #   #   # # #   # #
# ### ####### # # # ########### ### ### ##### # # ### # # # ##### # # ### ####### # ##### # ##### ###
#     #   #   # #           #   #   # #   #   # #       # #     # # # # #   # #         #           #
### ### ######### ### ##### # ##### # # # # ######### ### ######### ### # # # ####### ##### ####### #
# #         # #   # # #       #       # #     #         #   # #           #     #       #     #   # #
# # ####### # # # # # # ### ########### ### # ### ### ### # # ### # ### ####### # # ####### ### # ###
#         # #   # # # # #   # #       # # # #   # #     # #   #   # #   #   # # # # #     # # # #   #
# ### # # ##### ### # ##### # ### ### ### # ############### # ##### ### ### # ##### # ####### ### ###
# #   # # #     #         #   # # #   #       #     # #   # #     # #   #     #         #   # #   # #
##### ####### # # ############# # ####### ##### ##### ### ### ##### ##### ### # ##### ### # # # ### #
#   #   #     # #               # #     #       #                 # #   # #         #   # #         #
# ##### ##### ####### ### ### ### ##### ### ### # ### # ######### ### # # ########### ### ##### #####
#         #     # #   #   #         #   # #   #     # #   #   # #     #   #     #         #   #   # #
# ### ### # ##### # ##### ### ####### ### # ####### ####### # # # ##### ##### ### # ### ### ### ### #
# #     #     #   # #   # #   #   #         #         #   # #     #   # #       # # #     # #       #
# ########### # # # ### ##### # ##### # # ############### ### ##### ### ### ############### # #######
# # #     #   # # #     # # # #       # #             #           # # #             #     #         #
### # ### ### # # # ##### # # ##### # ### ### ### ### # # ### ### # # ### ### ######### # ######### #
#     #     # # #         #   # #   #   # #     #   # # #   # #   # #       #   # # # # #   #     # #
### # ### # # # # ##### # ##### ########### ##### # ### ########### ### # ##### # # # # # ### ##### #
#   # # # #   # # # #   # # #     # # #         # #   #     #   # #     #   #       #   #     #     #
# # # # # ####### # # ##### ### ### # ######### ### ### ##### # # # ##### # ####### # ######### # # #
# # # # # #   # # #     #   #   #       #     # #     # #     #   # # #   # #         #       # # # #
# ##### # # # # ##### ### # # ### ### ##### ##### ##### ####### # # # ### ######### ####### ### # # #
# # # #   # # #         # #         # #       #     # # # #   # # # #   # #   #       #         # # #
### # ### # ##### # ### ### # ### ### # # # ####### # ### ### ### # ### ### ############# ####### # #
#         #     # #   #   # #   # #   # # # # #   # #     # #   # #         #     #           #   # #
# # ### # # ####### # # ### ####### # # ##### # ### # ### # # # # # ##### ##### ### ### # # # #######
# # #   #         # # #   #     # # #     #   #   #   #       # #   #   #       # #   # # # #     # #
######### ### # # ####### # # ### ### # ### ### ### ##### # ####### ### ##### # # # ##### ####### # #
# #         # # # #     # # # #       #     #   # # #     #   # #     #     # #   # #       # # # # #
# # # # # ### # ##### ### ### ######### # ### ### ### # ##### # # ### # ######### ### ##### # # ### #
#   # # # #   #       #       # # # # # # #           #     # # # # #       #     #   #     # # #   #
### ### ### # ### ### # # # # # # # # # ######### ### ### ##### ### ### ##### # ####### # # # # # # #
#   #     # # #   # # # # # #       #   # # #     # #   #       #     # #     #   #     # #       # #
### ####### ##### # # # ####### # ##### # # ### # # ### ##### # # # ##### # ########### ##### #######
#   # #   # #   # # # # #   #   # #     #       #     # # #   #   #   # # #     # #     # # #   # # #
# # # # ### # ### # ##### ### # ### ### ### # ####### ### ##### ### ### # ##### # ####### # # ### # #
# #   #   # # # #   #   #   # #   # # #     # #   # # #       #   #     # # #   #       #     #   # #
# ##### ##### # ##### ### ####### ### ##### # # ### ##### ##### # ####### # ### ##### ########### # #
# #     #         #   #       #   # #   #   #             # #   # #   #     # #   #   #       #   # #
# ### # ### # ##### # # ### ####### # ### # # ########### # ##### # # ### ### ### ### ##### ### ### #
#     # #   #   #   #   # #   #       # # # # #   #     # #     # # #   # #     # #         #   #   #
# ######### ##### ### ### ### ### # ### # # ##### # ### ### ######### ### # ### # # ### ####### ### #
# #   #             #   #   # #   #       #         #   #       # # #         # #     # # #     #   #
# ### ### # # ####### # # # # ##### ################# # ##### # # # # ##### ### ##### ### ### ##### #
#     #   # # # #     # # #   #         #     # # # # #       #     # #     # # #   # # # # #   #   #
### ### # ##### ### ### ### # # # ##### # # # # # # ##### # # ##### ######### ### ##### # # # ### # #
#   #   #       #     # #   #   #   # #   # # #   #     # # #   #     #   #       # #             # #
# ##### ######### ### ##### ### ##### ### # ### ### # ####### ### # # ### ### # ### ### ### ##### ###
#   #       #   # #   # # #   #         # #     #   # #     # #   # #   #     #   # #     # #       #
##### # ####### ##### # # ### ####### ### # ### # # ##### # # # # ######### # ### # ####### ### #####
#     # #   #   #   #     # #   # #   # # # #     # #   # # # # # #   #     # #       # #     #     #
##### ##### ### # ### ##### ##### ##### ####### # ##### # ####### # ### ##### # ##### # # # #########
#   #   #           #   # #   # # #             # #       #             #     #   #     # #     # # #
# ### ####### ######### # # ### # ### # ##### # # # ### ##### # ############### ### ##### ### ### # #
# #     # #   #       #       #       #   # # # #   # #   # # #         # #       #     # #     #   #
# # # ### # # # # ### ### ##### ########### ### ### # ### # # ### ### ### # ### ####### ##### ##### #
#   #   #   #   # # #       #   # #               # # #     # #   # # #     # # #     #       # # # #
### ######### ### # # # ####### # # ##### # ##### ### ####### ### # # ####### ### # ### ### ### # # #
#   #         #     # #     #     # #     # #     #           #     #             # #     #         
################################################################################################### B
