A ###################
    #   # #       # #
# ### # # ### ### # #
#       # #         #
# ##### #   ### # # #
#   #     #   # # # #
### # ### # # ##### #
# #     #   # #     #
# # ### ### # # ### #
#                 # #
# # ### # # ### # ###
# #           # #   #
#   # ##### # # ### #
# # #   #   #     # #
### ### ##### ### ###
#   #     # #       #
# # # # # # # # ### #
# # # #   #   # #   #
### # # # ## ## # # #
#   # # #       #   
################### B