############
#A#        #
# # ## ### #
# #        #
#   #### # #
# #      # #
# # ### ## #
#          #
# ### ## # #
#       B# #
# # ###    #
############